15-ax
a--a-----------
--a-----------a
-------------a-
----a-------a--
-------------a-
---------------
----a----a-----
---------------
-----a-------a-
---------------
---------------
---------------
---------------
--aa------a----
---------------